/relation/has-task	has task
/relation/has-dataset	has dataset
/relation/has-best_rank	has best_rank
/relation/has-metric	has metric
/relation/has-value	has value
/relation/has-metrics	has metrics
/relation/has-methodology	has methodology
/relation/has-uses_additional_data	has uses_additional_data
/relation/has-paper	has paper
/relation/has-best_metric	has best_metric
/relation/has-evaluated_on	has evaluated_on
/relation/has-name	has name
/relation/has-url	has url
/relation/has-description	has description
/relation/has-full_name	has full_name
/relation/has-url_abs	has url_abs
/relation/has-url_pdf	has url_pdf
/relation/has-title	has title
/relation/has-abstract	has abstract
/relation/has-authors	has authors
/relation/has-published	has published
/relation/has-arxiv_id	has arxiv_id
/relation/has-proceeding	has proceeding
/relation/has-conference	has conference
/relation/has-conference_url_abs	has conference_url_abs
/relation/has-conference_url_pdf	has conference_url_pdf
